* * * * - - - - - - - - - *
* * * * * - - - - - - - - -
* * * - - - - - - - - - - -
* * - - - - @ - - - - - - -
* - - - - - - - - - - - - -
* * - - - - - - - - - - - -
* * * - - - - - - * - - - -
* * * * - - - t - - - - - -
* * * * * b b - - b * - - -
